ID,type,name,script,iconName,mapid,monsterid,timelimit,unlock,gold,clear1,clear1count,clear2,clear2count,clear3,clear3count,clear4,clear4count,clear5,clear5count
int,int,int,int,int,int,int,int,int,int,int,int,int,int,int,int,int,int,int,int
1101001,1,40100001,40110001,41000005,1,8001001,90,-1,40,610001,1,613001,2,612001,3,-1,-1,-1,-1
1101002,1,40100002,40110002,41000002,2,8001002,90,1101001,50,610001,2,613003,2,612002,3,-1,-1,-1,-1
1101003,1,40100003,40110003,41000003,3,8002001,90,1101002,60,610001,3,613002,2,612003,3,-1,-1,-1,-1
1101004,1,40100004,40110004,41000004,2,8001003,90,1101003,70,610001,4,613003,2,612004,3,-1,-1,-1,-1
1101005,1,40100005,40110005,41000001,1,8001004,90,1101004,80,610001,5,613001,2,612005,3,-1,-1,-1,-1
1102001,2,40200001,40210001,41000005,1,8001001,90,1101001,40,611001,2,613001,2,612001,3,-1,-1,-1,-1
1102002,2,40200002,40210002,41000004,2,8001003,90,1101001,70,611001,4,613003,2,612004,3,-1,-1,-1,-1
1102003,2,40200003,40210003,41000001,3,8001004,90,1101001,80,611001,5,613002,2,612005,3,-1,-1,-1,-1
1102004,2,40200004,40210004,41000003,2,8002001,90,1101001,60,611001,3,613003,2,612003,3,-1,-1,-1,-1
